    0   1   2   3   4   5   6   7
0   1   2   3   4   5   6   7   8
1   9   10  11  12  13  14  15  16
2   17   -1 -1  -1  -1  -1  -1   18
3   19   -1 -1  -1  -1  -1  -1   20
4   21  22  23  24  25  26  27  28